11111111111111111111111111111
1P100000111000000000000000001
10101110111111110110111111111
10001110111000000110110000001
11101110111011111110110111111
11101110000011000000110110011
11101111111111011011000001111
11100010000000011000000100111
11111001111111111111011111111
11111100111011111100011111111
11111111000011111101111111111
11111000111100000000000111111
11111011111101110111110111111
111110000000C110000000E111111
11111111111111111111111111111
