11111111111111111111111111111111111111111111111
1P000000111111000000000000000000000001111111111
10111110111111011111111111111111111100000011111
10111110111000011000000000111111111101011011111
10111110110111011011111110000001111101011011111
10111110110111000011111111111101111101011011111
10111110110111111111000000001101111101011011111
10111110000111111111011111101101100001010111111
10111110111111111111011111100001111100111011111
10000010000000000000011111101111111001111011111
11111001111111111111111111100000000100CE0011111
11111111111111111111111111111111111111111111111