11111111111111111
100X1000100X10001
1P100010C010001E1
1000100X1000100X1
11111111111111111
