11111111111111111
100X1000100X10001
1P1000100010001E1
10C0100X1000100X1
11111111111111111
