11111111111111111
1P000000000000001
10000000000000001
11000000000000001
1C000000000X000E1
11111111111111111
