111111111111
100100X00001
100001101101
1C010000X001
100101111101
1P0101E00001
111111111111



