111111111111
1001000C0001
100001111101
1C010000C0X1
10010000X001
1P0011E00001
111111111111



