111111111111
1001000C0001
100001111101
1C010000C001
100100000001
1P0011E00001
111111111111



