11111111111111111111111111111
1P100000111000000000000000001
10101110111111110110111011111
10001110111000000110110000001
110X1110111011111110110111111
11C01110000011000000110110011
11101111111111011011000001111
111000100000000110000X0100001
11111001111111111111011111101
11000100111011111100011100001
11011110000011111101111101111
110110011111000000C000X1X1111
11011011111101110111110101111
11011000X0000110000000E100011
11111111111111111111111111111