1111111111111111111111111
1P00100000000000001010001
1000001X1110X011101X00001
1000101010000000101010001
10001000110XCX01100010001
1000101010000000101010001
100000101110X0111X1000001
10001X00000000000000100E1
1111111111111111111111111
