11111111111111111111111111
1P001000000000000010100001
100000101110X0111010000001
10001010100000001010100001
10001000110XCX011000100001
10001010100000001010100001
100000101110X0111010000001
100010000000000000001000E1
11111111111111111111111111
